also remove image=ta även bort image
Apply=Verkställ
Are you sure=Är du säker?
Cancel=Avbryt
checking=
Completely REMOVE=
Console=Konsoll
day=dag
days=dagar
disk image and definition=
Disks=Diskar
Done=
Edit=Redigera
Execution error=
Force Stop=Tvinga stopp
Hibernate=
Log for=Log for:
log=logg
Logs=Loggar
More Info=Mer info
No=Nej
OK=
Ok=
Pause=
Proceed=Fortsätt
Project Page=Projektsida
Remove container=Ta bort container
Remove definition=
Remove image=Ta bort image
Remove VM=Ta bort VM
Remove=Ta bort
Restart=Starta om
Resume=Återuppta
Start=Starta
Stop=Stoppa
Support=
Update container=Uppdatera container
Update=Uppdatera
Updating all Containers=Uppdaterar alla containrar
Updating the container=Uppdaterar containern
VNC Remote=
WebUI=
Yes, delete it=Ja, ta bort den!
Yes, update it=Ja, uppdatera den!
Yes=Ja

; footer messages
Array Starting=Array startar
Array Stopping=Array stoppar
Mounting disks=Monterar diskar
Spinning up all drives=Spinner upp alla diskar
Starting services=Startar tjänster
Stopping services=Stoppar tjänster
Unmounting disks=
Autostart disabled=
Missing encryption key=
Opening encrypted volumes=
